add up - make sense
ask after - inquire about
back down - yield in an argument
bargain for - take into account
bear out - confirm the truth
break off - stop talking
break down - lose control of the emotions
break up - come to an end
bring about - cause to happen
bring off - succeed in doing something
bring on - cause the onset of an illness
bring on - cause trouble to happen to oneself
bring round - influence someone to your point of view
bring up - mention
call up - mobilise for military service
carry off - complete successfully - perhaps despite a problem
carry out - complete a plan
catch on - become popular
come about - happen
come down to - be in the end of a matter of (sprowadzać się do)
come in for - receive - especially criticism, blame
come off - take place successfully
come out - appear
come up - occur - usually a problem
come up against - meet a difficulty
come up to - equal (dorównać oczekiwaniom, standardom)
come up with - think of - especially an answer, a plan, a solition
count on - rely on
crop up - happen unexpectedly
do away with - abolish
do away with - murder
do up - decorate
draw up - come to a stop (zatrzymać się)
draw up - organise
drop in - pay a visit
drop off - fall asleep
end up - finish in a certain way, or place
face up to - have courage to deal with - especially responsibilities
fall about - show amusement - especially laughing
fall back on - use as a last resort
fall for - be deceived by (dać się nabrać, oszukać)
fall for - fall in love with
fall out with - quarrel with
fall through - fail to come to competition
feel up to - feel capable of doing
follow up - act upon a suggestion
follow up - take more action
get across - be understood - especially an idea (przekazywać)
get at - imply - about personal matters (sugerować)
get down - make to feel depressed
get down to - begin to seriously deal with
get on for - approach a certain age/time/number (zbliżać się do)
get on - make progress - especially in life
get over - be surprised (eg. couldn't get over it)
get over with - come to an end of something, usually unpleasant
get round to - find time to do - also around (zabrać się za coś)
get up to - do something - usually bad when about children (przeskrobać coś)